......#...
#....##.@.
....####..
.#..#....#
.........#
#..#.#....
....#.#...
.........#
...##.##..
..#.......
