.#..#.....
....###.#.
...@......
.....##...
..........
.........#
...#...#..
..........
##..#.....
...#..#.#.
